BACK	  	B AE K
FORWARD	F AO R W ER D
FULL	  	F UH L
HALF	  	HH AE F
LEFT	  	L EH F T
MOVE	  	M UW V
RIGHT	  	R AY T
SPEED	  	S P IY D
STOP	  	S T AA P
ROBOT     	R OW B AA T
TAKE      	T EY K
THE       	DH AH
PRINGLES  	P R IH NG G AH L Z
DRINK     	D R IH NG K
TO        	T UW
KITCHEN   	K IH CH AH N
TABLE     	T EY B AH L
LIVINGROOM	L IH V IH NG R UW M
BEDROOM	B EH D R UW M
ENTRANCE	EH N T R AH N S
